00010100000
00010101100
01110101100
00000100000
11110111100
01010000100
01010110100
00000110100
01110000100
00010110100
01010100000