0011011000
0101000000
0010010000
0000100010
0000001010
0010000110
0000010000
0000000000
0000100001
0000000100
0101000111
